===================
= X      $        =
= X      $        =
= X      $$$$$    =
= X      $        =
=========== =======
= %               =
===================

